            ###
            #P#
  ###########1###
###1111111111111#
#O1111111C111111#
####111111111111#
   ##############