#####   #####
#111#####111#
#1#1##P##1#1#
#11211211211####
###1##1##1####O#
 ##1##1##1####1#
 #1111211211#11##
 #C11#1##1#1#111#
 #11111##111##11#
 #11##########11#
 ##1111111111111#
  ###############