            ###
     #####  #O#
  ####111####1###
###111111111#111#
#P1111111111#111#
####111#1C111111#
   ##############