      #### ######
      #11###11#P#
      #1211121#1#
     ###1###1##1#
######112###1112#
#11###1#1#1#1##1##
#1211121212#21121#
#121111#1#1#1##1##
#122#221212121#1###
#122#11#1#1#1##111#
#122##11212121###L#
#122##11##1#11#O11#
#1221##############
#111K#
######