###############
#1111111111111#
#1###########1####
#1###O11111112111#
#1###########1##1#
#1###########P##1#
#1##############1#
#1##1111##11#C##1#
#1111111111112111#
#######111111#####
      ########