              ###
              #O#
            ###1###
  ###########21212#
  #11111111##2#1#2#
  #111####11#11211#
  #111121#11###1###
 ###21#11#1121#1###
 #112###1###1##L###
 #1#11K#21111#1222#
 #1#1#1#2#111#1##2#
 #112#1#1#111#1P#2#
 ###11221#111####2#
   #11#11#11222222#
   ################