            ###
    ####### #O#
    #11111# #1#
#####1###1###1#
#P1111# #11111#
####### #######