################
#11111111111111##
#1####1211111121#
#121111111111111#
#12#####1####1###
#12#####O####1#
#12#######11#1#
#11####11111#P#
#1112211###1###
#1#11111###1#
#111###11111#
##### #######