###################
#K1111111111111111#
#11122222222111121#
#11111111111111121#
#111111######11121#
#111111##P##221121#
#111111##1##221111#
#11111111111111111#
#11111111111111111#
#111111###1111###1#
#1111111112222L1#1#
#11##11###1111#O#1#
#11##2211#1111###1#
#11111111111111111#
###################