#####      #####
#111########111#
#1#1##1111##1#1#
#11111111111111#
##1####11####1##
 #1# #1111# #1#
 #P# #C111# #O#
 ### ###### ###